FE8 - Castle - 1800481a
15 20
212 212 185 912 913 911 867 912 912 913 914 911 867 912 913 914 186 212 212 212
244 473 217 944 948 946 419 944 944 945 946 946 419 944 948 946 218 473 244 244
276 505 217 979 627 689 849 976 976 627 978 689 849 979 627 981 218 505 276 276
276 537 217 784 785 785 719 688 976 627 689 978 719 785 785 785 218 537 276 277
276 276 249 784 785 785 751 721 947 625 628 721 751 785 785 785 250 276 213 277
500 565 502 288 289 290 484 721 688 627 978 721 484 288 289 290 499 564 565 565
721 721 531 720 721 721 516 721 721 721 721 721 516 720 721 721 531 723 722 721
721 721 531 720 719 721 1014 288 289 289 289 290 1014 721 719 721 531 720 721 721
721 721 531 720 751 721 721 721 656 595 657 721 721 721 751 721 531 720 721 721
918 918 918 583 721 721 721 719 596 625 628 719 721 721 721 583 918 918 918 918
950 951 952 615 720 719 720 751 596 625 628 751 721 719 720 615 950 951 952 950
982 983 984 982 721 751 484 721 596 625 628 721 484 751 721 982 982 983 984 982
548 548 548 775 720 721 516 721 596 625 628 721 516 755 721 775 779 548 548 548
785 785 785 810 720 719 864 721 596 625 628 721 864 719 721 810 784 785 785 785
785 785 785 548 755 751 721 721 596 625 628 721 721 751 721 548 784 785 785 785
